[level 1]

map = .......................................................................................................................................................................................................................................................................
      .........................b.............................................................................................................................................................................................................................................
      .......................................................................................................................................................................................................................................................................
      .......................................................................................................................................................................................................................................................................
      .......................................................................................................................................................................................................................................................................
      .......................................................................................................................................................................................................................................................................
      .......................................................................................................................................................................................................................................................................
      ....................b.b.b..............................................................................................................................................................................................................................................
      .......................................................................................................................................................................................................................................................................
      .......................................................................................................................................................................................................................................................................
      .......................................................................................................................................................................................................................................................................
      ___________________________________________..__________________________________________________________________________________________________________________________________________________________________________________________________________________________

[_]
name = ground
sprite = ground_block.jpg

[.]
name = air
sprite = None


[b]
name = bricks
sprite = brick_block.png

[c]
name = coin

[m]
name = mushroom

[p]
name = player


